Tie - связывать
Dare - осмелился
Breach - нарушить
Sanctum - святилище
Dash - crash
Bitter - горький
Mixologist - бармен
Alumni - выпускник
Wealthy - состоятельный
//We booted that loser last semester
Boot out - выгнали(без out тоже используется)
Pledge - клятва
//I say - перед высказыванием чтобы привлечь внимание
Crap - дерьмо(переносно)
Pull in(idiom) - въехать?
//After the crap she pulled in the Poe Cup?
Turn down(idiom) - отказаться
Black eye - синяк
Kidnap - похищение(людей)
Weave - ткать
Burial - погребальный
Shroud - саван
Prowl - бродить
Demise - кончина/погибель
Sharp - ровно
Dedication - торжественное открытие
Put your best face forward - выставить в лучшем свете
Obvi - obvious
//Ajax and I will be outreaching together?
//I will have it brought??
Hang - повесить
As long as - при условии
Stew - париться(не от огня)
Go out on a limb - идти на риск
Cannon fodder - пушечное мясо
//Whatever - (междометие)
Wage - вести/развязать
Track down - отслеживать
Generosity - щедрость
Trial - суд(над ведьмами там сжигали их, такой суд)
Prithee - пожалуйста
Privy - уборная
Haveth - олдовый have(рофл момент)
Pray - молить
Trove - клад сокровище
Muzzle - намордник
Blend - смесь
Fudge - стрепня
Sans - without
Strangle - душить
Break into - вломиться
Hand it over - давай сюда
How now - устаревшие what does it mean
Indeed - действительно
heebie-jeebies - тревога/депрессия
Totally dig - супер понравиться
Do a solid - сделать одолжение
Laid-back - спокойный
One hundo - сто проц
Sneak - пробраться
Hook up - перепихон(Лайт версии)
Sketchy - поверхностно
Obsess - преследовать(потом одержимость)
Spawn - отродье
Fold - народ
Expunge - избавить/ликвидировать от чего-то
Set it ablaze - подожгите это
Gather - собрать
To an extend - в какой-то степени
Be complicit - быть соучастником
Doom to - обречь
Doomed to - обречена
Exhausted - изнурительный
//You just napalm??
Coincidence - совпадение
Clue - улика
Pull smth - вытворить что-то
Adolescents - подростки
Underfunded - ндофинансируемая
Admire - восхищаюсь
Guffaw - хохотать
Pull (oneself) together (идиома) - возьми себя в руки
Confess - исповедоваться
Plague - мучиться
Afterburner - послевкусия
Tortue - пытка
Cold shoulder (idiom) - игнорировать
Fencing - фехтовальный
Prom - выпускной
Merely - посто
Peers -  сверстники
Nauseous - тошнотворный
Expell -  исколючить
To file - подать
Charges - обвинение
Trail - тропа
Way of putting it (idiom) - как бы это выразиться
сounselor - вожатый
Rip out - вырвать
Caw - карк
Nursery rhyme - детский стишок
Woe - горе
Back in the day - в те далекие времена
Sanity - здравомыслие
Intact - нетронуто
Board - правление
Court - суд
Driven mad - сведение с ума
Vivid - яркий
Howdy - привет
//I break out into hives
Peel off - отслаивается
Pitch - подача
Smirk - ухмыляется
Nefarious - подлый
Rumor - слух
Swirl - кружатся
Get someone off - снять уголовное обвинение
Pull string - заюзать власть
Quad - двор
Snarky - язвительный
Disdain - презрение
Cliques - bands
Fang - клык
Fur - мех
Bunch - кучка
Knuckleheads - болваны
Gossip - сплетни
Clueless - невежественный
Darken doorstep - заявиться на порог
Conjure - вызывать
Tchotchke - безделушка
Toe-curling - безвкусная
Hiker - пеший турист
Vomiting - рвать(рвота)
Coherent - последовательный
Diary - дневник, записки
Insipid - безвкусный
Whine - ныть
Fit in - вписаться
Nick - засечка
Deed - поступок
Rescued - спасенный
Mush - каша(месиво)
Favor - одолжение
Hide and seek - прятки
Casket - гроб
Olfactory sense - обоняние
Pick up - уловить
Feeble - немощная
Beneath someone (idiom) - слишком позорно
Bonding - сблизиться
Chauffeuring - шоферство
Crochets - вязанье крючком
Adversary - противник
Mutual - взаимный
Forge - ковать
Sanctuary - святилище
Endure - терпеть
Testicle - яичко
Powder room - дамская комната(туалет + душ)
Nail file - пилочка для ногтей
Weirdo - странный
Need-to-know basis - служебная информация(секретная)
Sweeten the pot - сделать Болле заманчивым(про деньги)
Zealot - фанатик
Vowed - клясться
Solitude - одиночество
Subtle - тонкий
Hint - намек
Curfew - комендантский час
Kooky - чокнутый
Spooky - жуткий
Crowd - толпа
Double back (idiom) - вернуться обратно
Call it a night (idiom) -  закругляться
Nada - ничего
Struggle - борьба
Search party - поисковая группа
Stick around (idiom) - задержаться(встать на одном месте)
Stumble upon (idiom) - споткнуться/наткнуться
Hibernate - зимовать
Occasional - случайная
Claim - утверждения
Witness - наблюдать/стать свидетелем
Bother - утруждать
Lure - заманивать
Adjust - приспосабливаться
Make it all up (idiom) - выдумать
Full disclosure (idiom) - на самом деле/честно говоря
Other than - (idiom) кроме/исключая
No offense - без обид
None taken - без обид(ответ)
Twisted - закрученный
Placate - успокоить
Well-rounded - всесторонне развитый
Remain - оставаться
Sharp-edged - односторонняя заточка
Tickle - защекочет
Little off - не в себе
Steer clear - держись подальше
Jerk - придурок
Hummers - жужжащие
Back off (idiom) - отвали
Sulk - дуться
Thrive - процветать
Ran into - столкнулся
Shrink - психиатр
Yakking - болтать
Reconsider - пересмотреть
Snap - сорваться
Chop-chop (idiom) - поторопись
Stubborn - упрямый
Obsessive - маниакальный
Get (smith) off (ones) chest (idiom) - тяготит
Hive - улей
Snitch - стукач
Sting - жалить
Deep down - в глубине души
Purr - мурлыкать